........###################################
........#.................................#
........#.G...............................#
........#######...........................#
........#.................................#
........#.................................#
........#.................................#
........#.................................#
........#.................................#
........#.........................P.......#
........###################################
